1111111111
0000000000
0F0000P000
0000000000
0000000000
0000000000
00000P0000
0000000000
0000000000
1111111111