1111111111
0000000000
0000000000
0000111000
00001F1000
0000111000
00000P0000
0000000000
0000000000
1111111111